SFFFFFFWFFFFFFF
WWWWWWFFFWWWWWF
FFFFFFFWFFFFFWF
FWWWWWFFFWWWFWW
FFFWWWWWFFFFFFF
WWFFFWWWWWFWWWF
FFFWFWWWFFFWWWF
FWFWFFFWFWFWWFF
WWFFWWFWFWFFWFW
FFFFFWFFFWWFFFF
WWFWWWWFWWWWWFW
FFFWWFFFWFFFFFW
FWWWWFWFFFWWWWW
WFFWFFWWWFFWWWW
GFFFFWWWFFWWWWW