SFFFFFFWFWWWWWW
WWWWWWFFFWWWWWW
FFFFFFFWFFFFFWW
FWWWWWFFFWWWFWW
FFFWWWWWFFFFFWW
WWFFFWWWWWFWWWW
FFFWFWWWFFFWWWW
FWFWFFFWFWFWWWW
WWFFWWFWFWFFWWW
FFFFFWFFFWWWWWW
WWFWWWWFWWWWWWW
FFFWWFFFWWWWWWW
FWWWWFWWWWWWWWW
WFFWFFWWWWWWWWW
GFFFFWWWWWWWWWW